11111111111111111
1CC1011001010C101
10110010C00000011
100010C0000C00001
1000P011101110E01
11111111111111111