111111111111111111111111111111
10000C0000000100000000C00C0001
1000P0000000010101000000000C01
100000000000010101000C00000001
1000000C00000101E100000000C001
1C00000000000C0111000000000001
100C000000011111C0000011111001
111111111111111111111111111111