111111111111111111111111111
10000000011100000000P000001
100000C00111000000000000001
10000000000C000000000000001
111111111111111111111111111