111111111111
100001110001
1P000C11E001
1000 1110001
1   11000111
111111111111