111111111111111111111
100000111000000001111
100P00000101110000E01
11111C00000T000000001
111111111111111111111
