11111111111111111111111111111111111111
11P00100000000000000001110000000000001
1111110000C000C000000110000000E0000001
1000000000000000000000C001110000000001
10000000000000000011100000000000100101
11111111111111111111111111111111111111