1111111111111111111111111111111111111111111111
1000000000000000000000000000000000000000000001
100000000000001100000000C000000001000000000001
10000000000001000000000000C00000P1000000000001
1000000000011100000C00000000000001000000000111
1000000000000000001110000000000000000000000001
1000000011111000000000000000000000000000000001
1000000110E01100000000000000000000000000000001
1111111111111111111111111111111111111111111111