1111111111111111111111111111111111111
100000000000000000000000000P000000001
1000000000000000000000000000000000001
1111111111111000000010000000011111111
1111E00000000000000111111100000000001
1111111111111111111111111111111111111