111111111111111111111111111111
10010C010000000000000000000001
100111110000000000000000000001
100000000E00000000C00000000001
100000000000000000000000P00001
111111111111111111111111111111