111111111111111111111
100000000000000110001
100000C00000000110C01
100000E0000000C000001
111111111111111111111