11111111111111
100000P000C001
1000E000000001
1000000000000001
11111111111111