11111111111111111111111111
1000000P000001111110000001
1000000C0000E0000000000001
100000000000000000E0000001
11111111111111111111111111
