11111111111111
100000P000C001
1000E000000001
100000000001
11111111111111